1111111
1P01111
1010011
1010101
1110101
1110121
1111111
