1111111
1100111
110K111
110D111
1100111
1100011
1111121