1111111
1100111
1100011
1100121
110T111
1100111
1111111
